

NO texture/north.xpm

SO texture/south.xpm

WE texture/west.xpm

EA texture/east.xpm

F 220,100,0


C 225,30,0

1111111111111111111111111
1000000000110000000000001
1011000001110000000000001
10010000N0000000000000001
1111111110110000011100001
10000000001100000111011111111
11110111111111011100000010001
11110111111111011101010010001
11000000110101011100000010001
10000000000000001100000000001
10000000000000001101010010001
11000001110101011111011110001
11110111 1110101 101100000001
11111111 1111111 11111111111
