
NO texture/north.xpm

SO texture/south.xpm

WE texture/west.xpm

EA texture/east.xpm

F 220,100,0


C 225,30,0

1111
10S01
10101
10001
1111
