
NO texture/north.xpm

SO texture/south.xpm

WE texture/west.xpm

EA texture/east.xpm

F 220,200,0


C 225,30,0

1111
10001
10001
100S1
1111
